0000000000000000000000000000
0000300000000000000000000000
000lpr0000000000000000000000
0000000000000000000000000300
000000000000000000300000lpr0
0007118000400070000000000000
7112222111111160000007111118
5222222222222260000005222226
5222222222222600000000522226