0000000000000000000000000000
0000300000000000000000000000
0000000000000000000000000000
0000000000000000033000000300
0000000000000000000000000000
1000000400000011111110000000
2111111111111122222221111111
2222222222222220000022222222
2222222222222200000000222222